1111111111111111111111111
10010000000C1000001110001
1000011111000000100000001
1P0011E00000C111100000001
1000000000000000000000001
100111001111111111C000001
1111110000C11111111110001
10000000000C1000000000001
1111110000000000000000001
1111111111111111111111111