11111111111111111111111111111111111111111
1CCCCCCCCCCCCCCCCCCC1CCCCCCCCCCCCCCCCCCC1
1C11111111111111111C1C11111111111111111C1
1CCCCCCCCCCCCCCCCCCC1CCCCCCCCCCCCCCCCCCC1
10101110000000011111111111000000001110101
1010111000000P000000000000000000001110101
10100000000000000000000000000000000000101
10000000000000000000000000000000000000001
11111000000001C1C100000111C1C100000011111
10001000000001C1CCCCCCCCC1C1C100000010001
10001000000001C1C1000001C1C1C100000010001
10001000000001C1C100E001C1C1C100000010001
10001000000001C1C1000001C1C1C100000010001
10001000000001C1CCCCCCCCC1C1C100000010001
11111000000001C1C100000111C1C100000011111
10000000000000000000000000000000000000001
10100000000000000000000000000000000000101
10101110000000000000000000000000001110101
10101110000000011111111111000000001110101
1CCCCCCCCCCCCCCCCCCC1CCCCCCCCCCCCCCCCCCC1
1C11111C11111111111C1C111111111C1111111C1
1CCCCCCCCCCCCCCCCCCC1CCCCCCCCCCCCCCCCCCC1
11111111111111111111111111111111111111111
