111111111111111111111111111111111111111111111111111111111111111111111111111
10010000000C1000001110000010000000C1000001110000010000000C10000011100000101
1000011111000000100000001010000000C1000001110000010000000C10000011100000101
1P0011E00000C111100000001010000000C1000001110000010000000C10000011100000101
1000000000000000000000001010000000C1000001110E00010000000C10000011100000101
100111001111111111C000001010000000C1000001110000010000000C10000011100000101
1111110000C11111111110001010000000C1000001110000010000000C10000011100000101
10000000000C1000000000001010000000C1000001110000010000000C10000011100000101
1111110000000000000000001010000000C1000001110000010000000C10000011100000101
111111111111111111111111111111111111111111111111111111111111111111111111111